...###
..##.#.####
.##..###..#
##.#####..#
#.#.@..#..#
###..###..#
..#..#....#
.##.##.#.##
.#......##
.#.##..##
.#######